###### ###
#$   #   #
#### ### #
#        #
# #### ###
# #    #$#
# ##$# # #
#@ ### # #
#   $#   #
##########